அ,ஆ,இ,ஈ,உ,ஊ,எ,ஏ,ஐ,ஒ,ஓ,ஔ,ஃ
க,கா,கி,கீ,கு,கூ,கெ,கே,கை,கொ,கோ,கௌ,க்
ங,ஙா,ஙி,ஙீ,ஙு,ஙூ,ஙெ,ஙே,ஙை,ஙொ,ஙோ,ஙௌ,ங்
ச,சா,சி,சீ,சு,சூ,செ,சே,சை,சொ,சோ,சௌ,ச்
ஞ,ஞா,ஞி,ஞீ,ஞு,ஞூ,ஞெ,ஞே,ஞை,ஞொ,ஞோ,ஞௌ,ஞ்
ட,டா,டி,டீ,டு,டூ,டெ,டே,டை,டொ,டோ,டௌ,ட்
ண,ணா,ணி,ணீ,ணு,ணூ,ணெ,ணே,ணை,ணொ,ணோ,ணௌ,ண்
த,தா,தி,தீ,து,தூ,தெ,தே,தை,தொ,தோ,தௌ,த்
ந,நா,நி,நீ,நு,நூ,நெ,நே,நை,நொ,நோ,நௌ,ந்
ப,பா,பி,பீ,பு,பூ,பெ,பே,பை,பொ,போ,பௌ,ப்
ம,மா,மி,மீ,மு,மூ,மெ,மே,மை,மொ,மோ,மௌ,ம்
ய,யா,யி,யீ,யு,யூ,யெ,யே,யை,யொ,யோ,யௌ,ய்
ர,ரா,ரி,ரீ,ரு,ரூ,ரெ,ரே,ரை,ரொ,ரோ,ரௌ,ர்
ல,லா,லி,லீ,லு,லூ,லெ,லே,லை,லொ,லோ,லௌ,ல்
வ,வா,வி,வீ,வு,வூ,வெ,வே,வை,வொ,வோ,வௌ,வ்
ழ,ழா,ழி,ழீ,ழு,ழூ,ழெ,ழே,ழை,ழொ,ழோ,ழௌ,ழ்
ள,ளா,ளி,ளீ,ளு,ளூ,ளெ,ளே,ளை,ளொ,ளோ,ளௌ,ள்
ற,றா,றி,றீ,று,றூ,றெ,றே,றை,றொ,றோ,றௌ,ற்
ன,னா,னி,னீ,னு,னூ,னெ,னே,னை,னொ,னோ,னௌ,ன்
